##########################
#    #o           #      #
#    #            #  ooo #
# A  #@   #   @@  #      #
#         #            @ #
#         #              #
##########################