##########################
#    #o@          #      #
#    #            # @ooo #
# A  #    #    @  #      #
#         #            @ #
#         #              #
##########################